RFLP	Restriction fragment length polymorphism
Restriction fragment length polymorphism	Restriction fragment length polymorphism
SSLP	Simple sequence length polymorphism
AFLP	Amplified fragment length polymorphism
RAPD	Random amplification of polymorphic DNA
VNTR	Variable number tandem repeat
Microsatellite 	Microsatellite/SSR
SSR	Microsatellite/SSR
ISSR	Microsatellite/SSR
Simple sequence repeat	Microsatellite/SSR
simple sequence repeat	Microsatellite/SSR
Simple Sequence Repeat	Microsatellite/SSR
SNP	Single nucleotide polymorphism
STR	Short tandem repeat
SFP	Single feature polymorphism
DArT	Diversity Arrays Technology
RAD	Restriction site associated DNA markers
PCR	PCR
STS	STS
SCAR	SCAR
